max_time 500
bomb_time 4
expl_duration 3
expl_range 3
+----------+
|          |
|WWWW      |
|       WWW|
|          |
|WWWWW     |
|       WWW|
|          |
|WWWWW     |
|       WWW|
|         E|
+----------+